A	AH
A(2)	EY
ARE	AA R
ARE(2)	ER
CAN	K AE N
CAN(2)	K AH N
COMPUTER	K AH M P Y UW T ER
DO	D UW
DOWN	D AW N
HAL	HH AE L
HAVE	HH AE V
HELP	HH EH L P
ME	M IY
MINUTE	M IH N AH T
MINUTE(2)	M AY N UW T
MINUTE(3)	M AY N Y UW T
OKAY	OW K EY
SHUT	SH AH T
THERE	DH EH R
UP	AH P
WAKE	W EY K
YOU	Y UW
